          *        B
          *   ******
          *         
          *         
          ********  
          *         
          *   ******
    *     *         
    *     *******      
    *     *         
    *     *         
    *     ******    
    *     *         
    *     *  *******
    *     *         
    *     *    *****
    *     *    *    
    *     *    *    
    *          *    
    *               
A   *               